{
    "10": 1,
    "9": 2,
    "8": 3,
    "7": 5,
    "6": 10,
    "5": 20,
    "4": 30,
    "3": 50,
    "2": 80,
    "1": 100
}
